20
20
W,1,1,1,1,W,1,1,1,1,W,1,1,1,1,1,1,1,1,W,
0,2,2,2,2,0,2,2,2,2,0,2,2,2,2,2,2,2,2,0,
0,2,2,2,2,0,2,2,2,2,0,2,2,2,2,2,2,2,2,0,
0,2,2,W,1,W,2,2,2,2,0,2,2,2,2,W,1,1,1,W,
0,2,2,0,2,W,W,1,1,1,W,1,1,1,1,W,2,2,2,0,
W,1,W,W,2,2,0,2,2,2,0,2,2,2,2,0,2,2,2,0,
2,2,0,2,2,2,0,2,2,2,0,2,2,2,2,0,2,2,2,0,
2,2,0,2,2,2,0,2,2,2,0,2,2,2,2,W,1,1,1,W,
1,W,W,1,1,W,W,1,1,1,W,1,1,1,1,W,2,2,2,0,
2,0,2,2,2,0,2,2,2,2,0,2,2,2,2,0,2,2,2,0,
2,0,2,2,2,0,2,2,2,2,0,2,2,2,2,0,2,2,2,0,
2,0,2,2,2,0,2,2,2,2,0,2,2,W,1,W,1,W,1,W,
1,W,1,1,1,W,1,1,W,1,W,1,1,W,2,2,2,0,2,2,
2,0,2,2,2,0,2,2,0,2,2,2,2,0,2,2,2,0,2,2,
2,0,2,2,2,0,2,2,0,2,2,2,W,W,W,2,2,0,2,2,
2,0,2,2,2,0,2,2,W,1,1,1,W,3,W,2,2,0,2,2,
2,0,2,2,2,0,2,2,0,2,2,2,W,W,W,1,1,W,2,2,
2,W,1,1,1,W,2,2,0,2,2,2,2,0,2,2,2,2,2,2,
2,2,2,2,2,0,2,2,0,2,2,2,2,0,2,2,2,2,2,2,
2,2,2,2,2,W,1,1,W,2,2,2,2,0,2,2,2,2,2,2,